ahh -> murr
awesome -> pawsome
awful -> pawful
bite -> nom
bottom -> femboy
bulge -> bulgy-wulgy
butthole -> tailhole
bye -> bai
celebrity -> popufur
cheese -> sergal
child -> cub
computer -> protogen
cum -> cummy wummy~
cyborg -> protogen
dad -> daddy
disease -> pathOwOgen
dog -> good boy
dragon -> derg
eat -> vore
father -> daddy
foot -> footpaw
for -> fur
fuck -> fluff
hand -> paw
hell -> hecc
hi -> hai
hyena -> yeen
kiss -> lick
lmao -> hehe~
love -> wuv
mouth -> maw
naughty -> knotty
not -> knot
perfect -> purrfect
persona -> fursona
pervert -> furvert
police -> pawlice
police department -> PAW Patrol
porn -> yiff
roar -> rawr
robot -> protogen
shout -> awoo
slut -> fox
smash -> smashie-washie
source -> sauce
straight -> gay
tale -> tail
the -> teh
this -> dis
toe -> toe bean
what -> wat
with -> wif
you -> chu
your -> ur